11 8 1
XXXXXXXX
XM..GX
X.G..X
X.J..X
X....X
X.J.JX
X.G..X
XXXXXXXX