6 8 1
XXXXXX
XM...X
X.G..X
X.J..X
X....X
X.J..X
X.G..X
XXXXXX