6 6 1
XXXXXX
XM...X
X.JJ.X
X.J..X
X.G..X
XXXXXX