10 11 5 
XXXXX  
X...XXXXX
X.......X
XXX.X.X.X
  X.X...X
 XX.XXX.XX
 X.GGG.G.X
 X..MG.J.X
 X.XXX.XXX
 X.....X
 XXXXXXX  