32 12 1
XXXXXXXXXXXXXXXXXXXXXXXXXXXXXXXX
X..........M...M....M..........X
XG.........................G...X
X....23..41..41..34...31.......X
XG...41..12..31..12...11...G...X
X....34..32..32..23...23.......X
XG...44..12..41..14...44...G...X
X....21..41..12..32...21.......X
XG...23..32..42..14...14...G...X
X..............................X
X..............................X
XXXXXXXXXXXXXXXXXXXXXXXXXXXXXXXX