7 8 1
XXXXXXX
XM...GX
X.....X
X.....X
X.JJ..X
X.J...X
X.G...X
XXXXXXX