7 8 1
XXXXXXX
XM....X
X.....X
XM....X
X.....X
X1234.X
XGGGG.X
XXXXXXX