32 12 1
XXXXXXXXXXXXXXXXXXXXXXXXXXXXXXXX
X..............................X
X.............................GX
X....23..41..41..34...31..M....X
X....41..12..31..12...11.......X
X....34..32..32..23...23......GX
X....44..12..41..14...44.......X
X....21..41..12..32...21..M....X
X....23..32..42..14...14......GX
X..............................X
X..............................X
XXXXXXXXXXXXXXXXXXXXXXXXXXXXXXXX