10 11 5
XXXXX  
XM..XXXXX
X.......X
XXX.X.X.X
  X.X...X
 XXXXXX.XX
 X...XX..X
 X..GX...X
 X.XXX.XXX
 X.....X
 XXXXXXX  