10 11 5
XXXXX  
X...XXXXX
X.......X
XXX.X.X.X
  X.X...X
 XX.XXX.XX
 X.GM..G.X
 X...G.J.X
 X.XXX.XXX
 X.JJ..X
 XXXXXXX  