28 12 1
XXXXXXXXXXXXXXXXXXXXXXXXXXXX
XM........................MX
XG.....................G...X
X....23..41..41..34........X
XG...41..12..31..12....G...X
X....34..32..32..23........X
XG...44..12..41..14....G...X
X....21..41..12..32........X
XG...23..32..42..14....G...X
X..........................X
X..........M...............X
XXXXXXXXXXXXXXXXXXXXXXXXXXXX